1111111111111111111111111111111111
1111111111111111111111111111110001
1111111111111111111111111111111111
1111111111111101111111111111111111
1111111C11111101111111111111111111
111111EPC1010101111111111111111111
1111111111111111111111111111111111