1111111111111111111
101C001111101110101
1010101111111111111
1000000P00000000C01
1011101011111010111
1111111011101010001
1000111011111010111
1010101011111110101
1110111010001010111
1000C00C10101E00001
1111111111111111111